init:{
    width=48
    height=48
    macro:A,MOSS_STONE
    macro:B,STONE_1
    macro:C,NULL
    macro:D,STAIR_BASE_CARPET
    macro:E,STAIR_LEFT
    macro:F,STAIR_BASE
    macro:G,MOLDING
    macro:H,STAIR_RIGHT
    macro:I,LADDER_LEFT
}

background:{
    A,A,A,A,A,A,A,A,A,A,A,A,A,A,A,A,A,A,A,A,A,A,A,A,A,A,A,A,A,A,A,A,A,A,A,A,A,A,A,A,A,A,A,A,A,A,A,A
    A,A,A,A,A,A,A,A,A,A,A,A,A,A,A,A,A,A,A,A,A,A,A,A,A,A,A,A,A,A,A,A,A,A,A,A,A,A,A,A,A,A,A,A,A,A,A,A
    A,A,A,A,A,A,A,A,A,A,A,A,A,A,A,A,A,A,A,A,A,A,A,A,A,A,A,A,A,A,A,A,A,A,A,A,A,A,A,A,A,A,A,A,A,A,A,A
    A,A,A,A,A,A,A,A,A,A,A,A,A,A,A,A,A,A,A,A,A,A,A,A,A,A,A,A,A,A,A,A,A,A,A,A,A,A,A,A,A,A,A,A,A,A,A,A
    A,A,A,A,A,A,A,A,A,A,A,A,A,A,A,A,A,A,A,A,A,A,A,A,A,A,A,A,A,A,A,A,A,A,A,A,A,A,A,A,A,A,A,A,A,A,A,A
    A,A,A,A,A,A,A,A,A,A,A,A,A,A,A,A,A,A,A,A,A,A,A,A,A,A,A,A,A,A,A,A,A,A,A,A,A,A,A,A,A,A,A,A,A,A,A,A
    A,A,A,A,A,A,A,A,A,A,A,A,A,A,A,A,A,A,A,A,A,A,A,A,A,A,A,A,A,A,A,A,A,A,A,A,A,A,A,A,A,A,A,A,A,A,A,A
    A,A,A,A,A,A,A,A,A,A,A,A,A,A,A,A,A,A,A,A,A,A,A,A,A,A,A,A,A,A,A,A,A,A,A,A,A,A,A,A,A,A,A,A,A,A,A,A
    A,A,A,A,A,A,A,A,A,A,A,A,A,A,A,A,A,A,A,A,A,A,A,A,A,A,A,A,A,A,A,A,A,A,A,A,A,A,A,A,A,A,A,A,A,A,A,A
    A,A,A,A,A,A,A,A,A,A,A,A,A,A,A,A,A,A,A,A,A,A,A,A,A,A,A,A,A,A,A,A,A,A,A,A,A,A,A,A,A,A,A,A,A,A,A,A
    A,A,A,A,A,A,A,A,A,A,A,A,A,A,A,A,A,A,A,A,A,A,A,A,A,A,A,A,A,A,A,A,A,A,A,A,A,A,A,A,A,A,A,A,A,A,A,A
    A,A,A,A,A,A,A,A,A,A,A,A,A,A,A,A,A,A,A,A,A,A,A,A,A,A,A,A,A,A,A,A,A,A,A,A,A,A,A,A,A,A,A,A,A,A,A,A
    A,A,A,A,A,A,A,A,A,A,A,A,A,A,A,A,A,A,A,A,A,A,A,A,A,A,A,A,A,A,A,A,A,A,A,A,A,A,A,A,A,A,A,A,A,A,A,A
    A,A,A,A,A,A,A,A,A,A,A,A,A,A,A,A,A,A,A,A,A,A,A,A,A,A,A,A,A,A,A,A,A,A,A,A,A,A,A,A,A,A,A,A,A,A,A,A
    A,A,A,A,A,A,A,A,A,A,A,A,A,A,A,A,A,A,A,A,A,A,A,A,A,A,A,A,A,A,A,A,A,A,A,A,A,A,A,A,A,A,A,A,A,A,A,A
    A,A,A,A,A,A,A,A,A,A,A,A,A,A,A,A,A,A,A,A,A,A,A,A,A,A,A,A,A,A,A,A,A,A,A,A,A,A,A,A,A,A,A,A,A,A,A,A
    A,A,A,A,A,A,A,A,A,A,A,A,A,A,A,A,A,A,A,A,A,A,A,A,A,A,A,A,A,A,A,A,A,A,A,A,A,A,A,A,A,A,A,A,A,A,A,A
    A,A,A,A,A,A,A,A,A,A,A,A,A,A,A,A,A,A,A,A,A,A,A,A,A,A,A,A,A,A,A,A,A,A,A,A,A,A,A,A,A,A,A,A,A,A,A,A
    A,A,A,A,A,A,A,A,A,A,A,A,A,A,A,A,A,A,A,A,A,A,A,A,A,A,A,A,A,A,A,A,A,A,A,A,A,A,A,A,A,A,A,A,A,A,A,A
    A,A,A,A,A,A,A,A,A,A,A,A,A,A,A,A,A,A,A,A,A,A,A,A,A,A,A,A,A,A,A,A,A,A,A,A,A,A,A,A,A,A,A,A,A,A,A,A
    A,A,A,A,A,A,A,A,A,A,A,A,A,A,A,A,A,A,A,A,A,A,A,A,A,A,A,A,A,A,A,A,A,A,A,A,A,A,A,A,A,A,A,A,A,A,A,A
    A,A,A,A,A,A,A,A,A,A,A,A,A,A,A,A,A,A,A,A,A,A,A,A,A,A,A,A,A,A,A,A,A,A,A,A,A,A,A,A,A,A,A,A,A,A,A,A
    A,A,A,A,A,A,A,A,A,A,A,A,A,A,A,A,A,A,A,A,A,A,A,A,A,A,A,A,A,A,A,A,A,A,A,A,A,A,A,A,A,A,A,A,A,A,A,A
    A,A,A,A,A,A,A,A,A,A,A,A,A,A,A,A,A,A,A,A,A,A,A,A,A,A,A,A,A,A,A,A,A,A,A,A,A,A,A,A,A,A,A,A,A,A,A,A
    A,A,A,A,A,A,A,A,A,A,A,A,A,A,A,A,A,A,A,A,A,A,A,A,A,A,A,A,A,A,A,A,A,A,A,A,A,A,A,A,A,A,A,A,A,A,A,A
    A,A,A,A,A,A,A,A,A,A,A,A,A,A,A,A,A,A,A,A,A,A,A,A,A,A,A,A,A,A,A,A,A,A,A,A,A,A,A,A,A,A,A,A,A,A,A,A
    A,A,A,A,A,A,A,A,A,A,A,A,A,A,A,A,A,A,A,A,A,A,A,A,A,A,A,A,A,A,A,A,A,A,A,A,A,A,A,A,A,A,A,A,A,A,A,A
    A,A,A,A,A,A,A,A,A,A,A,A,A,A,A,A,A,A,A,A,A,A,A,A,A,A,A,A,A,A,A,A,A,A,A,A,A,A,A,A,A,A,A,A,A,A,A,A
    A,A,A,A,A,A,A,A,A,A,A,A,A,A,A,A,A,A,A,A,A,A,A,A,A,A,A,A,A,A,A,A,A,A,A,A,A,A,A,A,A,A,A,A,A,A,A,A
    A,A,A,A,A,A,A,A,A,A,A,A,A,A,A,A,A,A,A,A,A,A,A,A,A,A,A,A,A,A,A,A,A,A,A,A,A,A,A,A,A,A,A,A,A,A,A,A
    A,A,A,A,A,A,A,A,A,A,A,A,A,A,A,A,A,A,A,A,A,A,A,A,A,A,A,A,A,A,A,A,A,A,A,A,A,A,A,A,A,A,A,A,A,A,A,A
    A,A,A,A,A,A,A,A,A,A,A,A,A,A,A,A,A,A,A,A,A,A,A,A,A,A,A,A,A,A,A,A,A,A,A,A,A,A,A,A,A,A,A,A,A,A,A,A
    A,A,A,A,A,A,A,A,A,A,A,A,A,A,A,A,A,A,A,A,A,A,A,A,A,A,A,A,A,A,A,A,A,A,A,A,A,A,A,A,A,A,A,A,A,A,A,A
    A,A,A,A,A,A,A,A,A,A,A,A,A,A,A,A,A,A,A,A,A,A,A,A,A,A,A,A,A,A,A,A,A,A,A,A,A,A,A,A,A,A,A,A,A,A,A,A
    A,A,A,A,A,A,A,A,A,A,A,A,A,A,A,A,A,A,A,A,A,A,A,A,A,A,A,A,A,A,A,A,A,A,A,A,A,A,A,A,A,A,A,A,A,A,A,A
    A,A,A,A,A,A,A,A,A,A,A,A,A,A,A,A,A,A,A,A,A,A,A,A,A,A,A,A,A,A,A,A,A,A,A,A,A,A,A,A,A,A,A,A,A,A,A,A
    A,A,A,A,A,A,A,A,A,A,A,A,A,A,A,A,A,A,A,A,A,A,A,A,A,A,A,A,A,A,A,A,A,A,A,A,A,A,A,A,A,A,A,A,A,A,A,A
    A,A,A,A,A,A,A,A,A,A,A,A,A,A,A,A,A,A,A,A,A,A,A,A,A,A,A,A,A,A,A,A,A,A,A,A,A,A,A,A,A,A,A,A,A,A,A,A
    A,A,A,A,A,A,A,A,A,A,A,A,A,A,A,A,A,A,A,A,A,A,A,A,A,A,A,A,A,A,A,A,A,A,A,A,A,A,A,A,A,A,A,A,A,A,A,A
    A,A,A,A,A,A,A,A,A,A,A,A,A,A,A,A,A,A,A,A,A,A,A,A,A,A,A,A,A,A,A,A,A,A,A,A,A,A,A,A,A,A,A,A,A,A,A,A
    A,A,A,A,A,A,A,A,A,A,A,A,A,A,A,A,A,A,A,A,A,A,A,A,A,A,A,A,A,A,A,A,A,A,A,A,A,A,A,A,A,A,A,A,A,A,A,A
    A,A,A,A,A,A,A,A,A,A,A,A,A,A,A,A,A,A,A,A,A,A,A,A,A,A,A,A,A,A,A,A,A,A,A,A,A,A,A,A,A,A,A,A,A,A,A,A
    A,A,A,A,A,A,A,A,A,A,A,A,A,A,A,A,A,A,A,A,A,A,A,A,A,A,A,A,A,A,A,A,A,A,A,A,A,A,A,A,A,A,A,A,A,A,A,A
    A,A,A,A,D,D,D,A,A,A,A,A,A,A,A,A,A,A,A,A,A,A,A,A,A,A,A,A,A,A,A,A,A,A,A,A,A,A,A,A,A,A,A,A,A,A,A,A
    A,A,A,A,A,A,A,A,A,A,A,A,A,A,A,A,A,A,A,A,A,A,A,A,A,A,A,A,A,A,A,A,A,A,A,A,A,A,A,A,A,A,A,A,A,A,A,A
    A,A,A,A,A,A,A,A,A,A,A,A,A,A,A,A,A,A,A,A,A,A,A,A,A,A,A,A,A,A,A,A,A,A,A,A,A,A,A,A,A,A,A,A,A,A,A,A
    A,A,A,A,A,A,A,A,A,A,A,A,A,A,A,A,A,A,A,A,A,A,A,A,A,A,A,A,A,A,A,A,A,A,A,A,A,A,A,A,A,A,A,A,A,A,A,A
    A,A,A,A,A,A,A,A,A,A,A,A,A,A,A,A,A,A,A,A,A,A,A,A,A,A,A,A,A,A,A,A,A,A,A,A,A,A,A,A,A,A,A,A,A,A,A,A
}

foreground:{
    B,B,B,B,B,B,B,B,B,B,B,B,B,B,B,B,B,B,B,B,B,B,B,B,B,B,B,B,B,B,B,B,B,B,B,B,B,B,B,B,B,B,B,B,B,B,B,B
    B,B,B,B,B,B,B,B,B,B,B,B,B,B,B,B,B,B,B,B,B,B,B,B,B,B,B,B,B,B,B,B,B,B,B,B,B,B,B,B,B,B,B,B,B,B,B,B
    B,B,B,B,B,B,B,B,B,B,B,B,B,B,B,B,B,B,B,B,B,B,B,B,B,B,B,B,B,B,B,B,B,B,B,B,B,B,B,B,B,B,B,B,B,B,B,B
    B,B,B,B,B,B,B,B,B,B,B,B,B,B,B,B,B,B,B,B,B,B,B,B,B,B,B,B,B,B,B,B,B,B,B,B,B,B,B,B,B,B,B,B,B,B,B,B
    B,B,B,B,B,B,B,B,B,B,B,B,B,B,B,B,B,B,B,B,B,B,B,B,B,B,B,B,B,B,B,B,B,B,B,B,B,B,B,B,B,B,B,B,B,B,B,B
    B,B,B,B,B,B,B,B,B,B,B,B,B,B,B,B,B,B,B,B,B,B,B,B,B,B,B,B,B,B,B,B,B,B,B,B,B,B,B,B,B,B,B,B,B,B,B,B
    B,B,B,B,B,B,B,B,B,B,B,B,B,B,B,B,B,B,B,B,B,B,B,B,B,B,B,B,B,B,B,B,B,B,B,B,B,B,B,B,B,B,B,B,B,B,B,B
    B,B,B,B,B,B,B,B,B,B,B,B,B,B,B,B,B,B,B,B,B,B,B,B,B,B,B,B,B,B,B,B,B,B,B,B,B,B,B,B,B,B,B,B,B,B,B,B
    B,B,B,B,B,B,B,B,B,B,B,B,B,B,B,B,B,B,B,B,B,B,B,B,B,B,B,B,B,B,B,B,B,B,B,B,B,B,B,B,B,B,B,B,B,B,B,B
    B,B,B,B,B,B,B,B,B,B,B,B,B,B,B,B,B,B,B,B,B,B,B,B,B,B,B,B,B,B,B,B,B,B,B,B,B,B,B,B,B,B,B,B,B,B,B,B
    B,B,B,B,B,B,B,B,B,B,B,B,B,B,B,B,B,B,B,B,B,B,B,B,B,B,B,B,B,B,B,B,B,B,B,B,B,B,B,B,B,B,B,B,B,B,B,B
    B,B,B,B,B,B,B,B,B,B,B,B,B,B,B,B,B,B,B,B,B,B,B,B,B,B,B,B,B,B,B,B,B,B,B,B,B,B,B,B,B,B,B,B,B,B,B,B
    B,B,B,B,B,B,B,B,B,B,B,B,B,B,B,B,B,B,B,B,B,B,B,B,B,B,B,B,B,B,B,B,B,B,B,B,B,B,B,B,B,B,B,B,B,B,B,B
    B,B,B,B,B,B,B,B,B,B,B,B,B,B,B,B,B,B,B,B,B,B,B,B,B,B,B,B,B,B,B,B,B,B,B,B,B,B,B,B,B,B,B,B,B,B,B,B
    B,B,B,B,B,B,B,B,B,B,B,B,B,C,C,C,C,C,C,C,B,B,B,B,B,B,B,B,B,B,B,B,B,B,B,B,B,B,B,B,B,B,B,B,B,B,B,B
    B,B,B,B,B,B,B,B,B,B,B,B,B,C,C,C,C,C,C,C,B,B,B,B,B,B,B,B,B,B,B,B,B,B,B,B,B,B,B,B,B,B,B,B,B,B,B,B
    B,B,B,B,B,B,B,B,B,B,B,B,B,C,C,C,C,C,C,C,C,C,C,C,C,C,C,C,C,C,C,C,C,C,C,C,C,C,B,B,B,B,B,B,B,B,B,B
    B,B,B,B,B,B,B,B,B,B,B,B,B,C,C,C,C,C,C,C,C,C,C,C,C,C,C,C,C,C,C,C,C,C,C,C,C,C,B,B,B,B,B,B,B,B,B,B
    B,B,B,B,B,B,B,B,B,B,B,B,B,C,C,C,C,C,C,C,C,C,C,C,C,C,C,C,C,C,C,C,C,C,C,C,C,C,B,B,B,B,B,B,B,B,B,B
    B,B,B,B,B,B,B,B,B,B,B,B,B,C,C,C,C,C,C,C,C,C,C,C,C,C,C,C,C,C,C,C,C,C,C,C,C,C,B,B,B,B,B,B,B,B,B,B
    B,B,B,B,B,B,B,B,B,B,B,B,B,D,D,D,D,D,D,D,D,E,C,C,C,C,C,C,C,C,C,C,C,C,C,C,C,C,C,C,B,B,B,B,B,B,B,B
    B,B,B,B,B,B,B,B,B,B,B,B,B,B,B,B,B,B,B,B,F,F,E,C,C,C,C,C,C,C,C,C,C,C,C,C,C,C,C,C,B,B,B,B,B,B,B,B
    B,B,B,B,B,B,B,B,B,B,B,B,B,B,B,B,B,B,B,B,F,F,F,E,G,G,G,G,G,G,G,G,G,G,G,G,G,G,C,C,B,B,B,B,B,B,B,B
    B,B,B,B,B,B,B,B,B,B,B,B,B,B,B,B,B,B,B,B,F,F,F,F,D,D,D,D,D,D,D,D,D,D,D,D,D,D,C,C,B,B,B,B,B,B,B,B
    B,B,B,B,B,B,B,B,B,B,B,B,B,B,B,B,B,B,B,B,B,B,B,B,B,B,B,B,B,B,B,B,B,B,B,B,B,B,C,C,B,B,B,B,B,B,B,B
    B,B,B,B,B,B,B,B,B,B,B,B,B,B,B,B,B,B,B,B,B,B,B,B,B,B,B,B,B,B,B,B,B,B,B,B,B,B,C,C,B,B,B,B,B,B,B,B
    B,B,B,B,B,B,B,B,B,B,B,B,B,B,B,B,B,B,B,B,B,B,B,B,B,B,B,B,B,B,B,B,B,B,B,B,B,B,C,C,B,B,B,B,B,B,B,B
    B,B,B,B,B,B,B,B,B,B,B,B,B,B,A,B,B,B,B,B,B,B,B,B,B,B,B,B,B,B,B,B,B,B,B,B,B,B,C,C,B,B,B,B,B,B,B,B
    B,B,B,B,B,B,B,B,B,B,B,B,B,B,B,B,B,B,B,B,B,B,B,B,B,B,B,B,B,B,B,B,B,B,B,B,B,B,C,C,B,B,B,B,B,B,B,B
    B,B,B,B,B,B,B,B,B,B,B,B,B,B,B,B,B,B,B,B,B,B,B,B,B,B,B,B,B,B,B,B,B,B,B,B,B,B,C,C,B,B,B,B,B,B,B,B
    B,B,B,B,B,B,B,B,B,B,B,B,B,B,B,B,A,B,B,B,B,B,A,B,B,B,A,B,B,B,B,B,B,B,B,B,B,B,C,C,B,C,C,C,C,C,C,B
    B,B,B,B,B,B,B,B,B,B,B,B,B,B,B,B,B,B,B,B,B,B,B,B,B,B,B,B,B,B,B,B,B,B,B,B,B,B,C,C,B,C,C,C,C,C,C,B
    B,B,B,B,B,B,B,B,B,B,B,B,B,B,B,B,B,B,B,B,B,B,B,B,B,B,B,B,B,B,B,B,B,B,B,B,B,B,C,C,B,C,C,C,C,C,C,B
    B,B,B,B,B,B,B,B,B,B,B,B,B,B,B,B,B,C,C,C,C,C,B,B,B,B,B,B,B,B,B,B,B,B,B,B,B,B,C,C,B,C,C,C,C,C,C,B
    B,B,B,B,B,B,B,B,B,B,B,B,C,C,C,C,C,C,C,C,C,C,C,C,C,C,B,B,B,B,B,B,B,B,B,B,B,B,C,C,B,C,C,C,C,C,C,B
    B,B,B,B,B,B,B,C,C,C,C,C,C,C,C,C,C,C,C,C,C,C,C,C,C,C,C,C,C,C,C,B,B,B,B,B,B,B,C,C,B,C,C,C,C,C,C,B
    B,B,B,B,B,C,C,C,C,C,C,C,C,C,C,C,C,C,C,C,C,C,C,C,C,C,C,C,C,C,C,C,C,B,B,B,B,B,C,C,B,C,C,C,C,C,C,B
    B,B,C,C,C,C,C,C,C,C,C,C,C,C,C,C,C,C,C,C,C,C,C,C,C,C,C,C,C,C,C,C,C,C,C,C,B,B,C,C,B,C,C,C,C,C,C,B
    B,C,C,C,C,C,C,C,C,C,C,C,C,C,C,C,C,C,C,C,C,C,C,C,C,C,C,C,C,C,C,C,C,C,C,C,C,C,C,C,C,C,C,C,C,C,C,B
    B,C,C,C,C,C,C,C,C,C,C,C,C,C,C,C,C,C,C,C,C,C,C,C,C,C,C,C,C,C,C,C,C,C,C,C,C,C,C,C,C,C,C,C,C,C,C,B
    B,C,C,C,C,C,C,C,C,C,C,C,C,C,C,C,C,C,C,C,C,C,C,C,C,C,C,C,C,C,C,C,C,C,C,C,C,C,C,C,C,C,C,C,C,C,C,B
    B,C,C,C,C,C,C,C,C,C,C,C,C,C,C,C,C,C,C,C,C,C,C,C,C,C,C,C,C,C,C,C,C,C,C,C,C,C,C,C,C,C,C,C,C,C,C,B
    B,G,G,G,G,G,G,G,G,G,G,G,G,G,G,G,G,G,G,G,G,G,G,G,G,G,G,G,G,G,G,G,G,G,G,G,H,D,D,D,D,E,G,G,G,G,G,B
    F,D,D,D,D,D,D,I,C,C,C,C,C,D,D,D,D,I,C,C,C,C,C,D,D,D,D,I,C,C,C,C,C,D,D,D,F,F,F,F,F,F,D,D,D,D,D,D
    F,F,F,F,F,F,F,I,C,C,C,C,C,F,F,F,F,I,C,C,C,C,C,F,F,F,F,I,C,C,C,C,C,F,F,F,F,F,F,F,F,F,F,F,F,F,F,F
    F,F,F,F,F,F,F,I,C,C,C,C,C,F,F,F,F,I,C,C,C,C,C,F,F,F,F,I,C,C,C,C,C,F,F,F,F,F,F,F,F,F,F,F,F,F,F,F
    F,F,F,F,F,F,F,I,C,C,C,C,C,F,F,F,F,I,C,C,C,C,C,F,F,F,F,I,C,C,C,C,C,F,F,F,F,F,F,F,F,F,F,F,F,F,F,F
    F,F,F,F,F,F,F,F,F,F,F,F,F,F,F,F,F,F,F,F,F,F,F,F,F,F,F,F,F,F,F,F,F,F,F,F,F,F,F,F,F,F,F,F,F,F,F,F
}

collisions:{
    0t,26t,32t,1t
    19t,20t,1t,6t
    0t,20t,1t,6t
    3t,23t,2t,1t
    0t,26t,32t,1t
    19t,20t,1t,6t
    0t,20t,1t,6t
    3t,23t,2t,1t
    0t,47t,48t,1t
    0t,43t,7t,1t
    13t,43t,4t,1t
    23t,43t,4t,1t
    33t,43t,15t,1t
    0t,44t,1t,3t
    6t,44t,1t,3t
    13t,44t,1t,3t
    16t,44t,1t,3t
    23t,44t,1t,3t
    26t,44t,1t,3t
    33t,44t,1t,3t
    47t,44t,1t,3t
    37t,42t,5t,1t
    20t,23t,17t,1t
    13t,20t,8t,1t
    12t,13t,1t,8t
    37t,23t,1t,15t
    40t,13t,1t,25t
    0t,36t,1t,7t
    47t,37t,1t,6t
}

entities:{
    WATER{448,2944,6,1}
    WATER{1088,2944,6,1}
    WATER{1728,2944,6,1}
    SPAWN_POINT{128,2688,}
    PEDESTAL{322,2711,ped1}
    PEDESTAL{963,2709,ped2}
    PEDESTAL{1597,2714,ped3}
    PEDESTAL{928,1238,ped4}
    DOOR{1600,1344,false,door1}
    LIGHT{321,2661,64,0,255,0,led1}
    LIGHT{962,2658,64,0,255,0,led2}
    LIGHT{1595,2659,64,0,255,0,led3}
    TIMER{301,1938,600,timer1}
    TIMER{938,1771,600,timer2}
    TIMER{1470,1949,600,timer3}
    TIMER{2620,2844,400,timer4}
    TIMER{928,1525,120,timer5}
    FLOOR_LAMP{192,2816,0,255,0,floorLamp}
    RS_LATCH{560,2157,latch1}
    RS_LATCH{1045,1949,latch2}
    RS_LATCH{1670,1958,latch3}
    RS_LATCH{2673,2898,latch4}
    RS_LATCH{1017,1397,latch5}
    GRATE{512,2688,grate1}
    GRATE{1152,2688,grate2}
    GRATE{1792,2688,grate3}
    NOT_GATE{1877,2194,not1}
    NOT_GATE{2304,2222,not2}
    NOT_GATE{2393,2929,not3}
    NOT_GATE{1272,1556,resetGate}
    NOT_GATE{1381,1484,not4}
    NOT_GATE{782,1478,not5}
    OR_GATE{2154,2116,or1}
    AND_GATE{1108,1395,and1}
    AND_GATE{651,1344,and2}
    GATE{2425,2564,gate1}
    GATE{2569,2561,gate2}
    GATE{1289,1151,gate3}
    TELEPORTER{1152,1216,tele1}
    TELEPORTER{-4672,-3200,tele2}
    BUFFER{771,1011,4,buffer1}
    ELEVATOR{2495,2626,elevator1}
    WIRE{ped1,0,latch1,0}
    WIRE{ped2,0,latch2,0}
    WIRE{ped3,0,latch3,0}
    WIRE{latch1,2,timer1,0}
    WIRE{latch2,2,timer2,0}
    WIRE{latch3,2,timer3,0}
    WIRE{timer1,1,grate1,0}
    WIRE{timer2,1,grate2,0}
    WIRE{timer3,1,grate3,0}
    WIRE{latch1,0,or1,0}
    WIRE{latch2,0,or1,1}
    WIRE{latch3,0,not1,0}
    WIRE{not1,1,or1,2}
    WIRE{or1,4,not2,0}
    WIRE{not2,1,gate1,0}
    WIRE{gate1,0,not3,0}
    WIRE{not3,1,gate2,0}
    WIRE{or1,0,led1,0}
    WIRE{or1,1,led2,0}
    WIRE{or1,2,led3,0}
    WIRE{elevator1,2,latch4,0}
    WIRE{latch4,2,timer4,0}
    WIRE{timer4,1,elevator1,0}
    WIRE{resetGate,1,and1,0}
    WIRE{resetGate,0,tele1,0}
    WIRE{and1,2,not4,0}
    WIRE{not4,1,gate3,0}
    WIRE{ped4,0,latch5,0}
    WIRE{latch5,2,and2,0}
    WIRE{latch5,2,timer5,0}
    WIRE{timer5,1,not5,0}
    WIRE{not5,1,and2,1}
    WIRE{and2,2,buffer1,0}
    WIRE{buffer1,1,tele2,0}
    WIRE{latch5,2,and1,1}
    WIRE{resetGate,0,door1,0}
    LOG{686,2944,3}
    LOG{1981,2944,3}
    LOG{1323,2944,3}
    BOOK_SHELF{2880,2656,true}
    BARREL{2752,2688}barrel1.txt
    FLOOR_LANTERN{3008,2816,0,255,0,id:0.03016819303723106}
    BOOK_SHELF{1920,1376,true}
    BOOK_SHELF{2240,1376,false}
    CHEST{2075,1426,true}chest1.txt
    FLOOR_LAMP{1792,1536,0,255,0,id:0.500653352018112}
    FLOOR_LANTERN{2176,1536,0,255,0,id:0.9534531821453527}
    FLOOR_LANTERN{1216,1344,0,255,0,id:0.09231340785432329}
    FLOOR_LAMP{2240,2816,0,255,0,id:0.9790955208268718}
    WARP{1600,896,1,1,Rift,false,4,0,false,warp1}
    WIRE{door1,1,warp1,0}
    SPAWN_POINT{213,2702,}
}

